10 10
K........G
.XXX.XXXX.
.XXX.XXXX.
..........
.XXXX.XXX.
.XXXX.XXX.
.........G
.XXX.XXXX.
.XXX.XXXX.
S........T