10 10
..........
XX...XX...
X.........
XXXXXXX...
....X.....
XX..X.X...
....XXX...
XX...XX...
S.........
XX...XX...
