10 10
........TX
XX...XX...
X.........
XXXXXXX...
....XG....
XX..XGX...
....XXX...
XX...XX.K.
XS.......X
XX...XX...
