10 10
.........X
XX...XX...
X.........
XXXXXXX...
....XG....
XX..XGX...
....XXX...
XX...XX...
XS.......X
XX...XX...
