5 10
.G......T.
..XXXXX...
..........
.S......K.
..........