16 16
.......XX......K
.XXX.X.XX.X.XXX.
.XXX.X.XX.X.XXX.
................
.XXX.XXXXXX.XXX.
.....XGXXGX.....
XXXX.X.XX.X.XXXX
...X........X...
...X........X...
XXXX.X.XX.X.XXXX
.....XGXXGX.....
.XXX.XXXXXX.XXX.
................
.XXX.X.XX.X.XXX.
.XXX.X.XX.X.XXX.
T......XX......S